
[6, 6, 6, 6, 6, 6, 6, 6, 6, 6, 6, 6, 6, 6, 6, 6, 6, 6, 6, 6, 6, 6, 6, 6, 6,
 6, 0, 0, 3, 0, 0, 0, 0, 0, 0, 0, 0, 3, 0, 0, 0, 0, 0, 0, 0, 0, 3, 0, 0, 6,
 6, 0, 0, 0, 0, 0, 0, 0, 0, 0, 0, 0, 0, 0, 0, 0, 0, 0, 0, 0, 0, 0, 0, 0, 6,
 6, 0, 0, 5, 5, 0, 0, 0, 0, 0, 0, 0, 0, 0, 0, 0, 0, 0, 0, 0, 5, 5, 0, 0, 6,
 6, 0, 5, 5, 5, 5, 0, 0, 0, 6, 6, 6, 6, 6, 6, 6, 0, 0, 0, 5, 5, 5, 5, 0, 6,
 6, 0, 0, 5, 5, 0, 0, 0, 0, 0, 0, 0, 0, 0, 0, 0, 0, 0, 0, 0, 5, 5, 0, 0, 6,
 6, 0, 0, 0, 0, 0, 5, 5, 5, 0, 0, 0, 0, 0, 0, 0, 5, 5, 5, 0, 0, 0, 0, 0, 6,
 6, 0, 0, 0, 0, 0, 0, 0, 0, 0, 5, 5, 5, 5, 5, 0, 0, 0, 0, 0, 0, 0, 0, 0, 6,
 6, 6, 6, 6, 6, 6, 6, 0, 0, 5, 5, 5, 5, 5, 5, 5, 0, 0, 6, 6, 6, 6, 6, 6, 6,
 6, 0, 0, 0, 0, 0, 0, 0, 0, 0, 5, 5, 5, 5, 5, 0, 0, 0, 0, 0, 0, 0, 0, 0, 6,
 6, 0, 0, 0, 0, 0, 0, 0, 0, 0, 0, 0, 0, 0, 0, 0, 0, 0, 0, 0, 0, 0, 0, 0, 6,
 6, 0, 0, 5, 5, 5, 5, 0, 0, 0, 0, 0, 0, 0, 0, 0, 0, 0, 0, 5, 5, 5, 0, 0, 6,
 6, 0, 5, 5, 5, 5, 5, 5, 0, 6, 6, 6, 6, 6, 6, 6, 0, 0, 5, 5, 5, 5, 5, 0, 6,
 6, 0, 0, 5, 5, 5, 5, 0, 0, 0, 0, 0, 0, 0, 0, 0, 0, 0, 0, 5, 5, 5, 0, 0, 6,
 6, 0, 0, 0, 0, 0, 0, 0, 0, 0, 5, 5, 5, 5, 5, 0, 0, 0, 0, 0, 0, 0, 0, 0, 6,
 6, 0, 0, 1, 0, 0, 0, 0, 0, 0, 5, 5, 5, 5, 5, 0, 0, 0, 0, 0, 0, 2, 0, 0, 6,
 6, 0, 0, 0, 0, 0, 0, 0, 0, 0, 5, 5, 13, 5, 5, 0, 0, 0, 0, 0, 0, 0, 0, 0, 6,
 6, 6, 6, 6, 6, 6, 6, 6, 6, 6, 6, 6, 6, 6, 6, 6, 6, 6, 6, 6, 6, 6, 6, 6, 6],

[6, 6, 6, 6, 6, 6, 6, 6, 6, 6, 6, 6, 6, 6, 6, 6, 6, 6, 6, 6, 6, 6, 6, 6, 6,
6, 0, 0, 3, 0, 0, 0, 0, 0, 0, 0, 0, 3, 0, 0, 0, 0, 0, 0, 0, 0, 3, 0, 0, 6,
6, 0, 0, 0, 0, 0, 0, 0, 0, 0, 0, 0, 0, 0, 0, 0, 0, 0, 0, 0, 0, 0, 0, 0, 6,
6, 0, 0, 0, 0, 0, 0, 0, 0, 6, 0, 0, 5, 5, 5, 6, 0, 0, 0, 0, 0, 0, 0, 0, 6,
6, 0, 0, 0, 0, 0, 0, 0, 0, 6, 5, 0, 0, 5, 5, 6, 0, 0, 0, 0, 0, 0, 0, 0, 6,
6, 0, 0, 0, 6, 6, 6, 6, 6, 6, 5, 0, 0, 5, 5, 6, 0, 0, 0, 6, 6, 6, 6, 6, 6,
6, 0, 0, 0, 5, 5, 0, 0, 0, 6, 5, 5, 0, 0, 5, 6, 0, 0, 0, 5, 5, 0, 0, 0, 6,
6, 0, 0, 0, 5, 5, 0, 0, 0, 6, 5, 5, 5, 0, 0, 6, 0, 0, 0, 5, 5, 0, 0, 0, 6,
6, 9, 9, 9, 9, 0, 0, 0, 0, 6, 5, 5, 5, 5, 0, 6, 9, 9, 9, 9, 0, 0, 0, 0, 6,
6, 9, 9, 9, 9, 0, 0, 0, 0, 6, 5, 5, 0, 0, 0, 6, 9, 9, 9, 9, 0, 0, 0, 0, 6,
6, 6, 6, 6, 6, 6, 0, 0, 0, 6, 0, 0, 0, 5, 5, 6, 6, 6, 6, 6, 6, 0, 0, 0, 6,
6, 0, 0, 0, 0, 5, 0, 0, 0, 6, 0, 0, 5, 5, 5, 6, 0, 0, 0, 0, 0, 0, 0, 0, 6,
6, 0, 0, 0, 0, 5, 0, 0, 0, 0, 0, 0, 0, 0, 0, 0, 0, 0, 0, 0, 0, 0, 0, 0, 6,
6, 0, 0, 0, 0, 0, 0, 0, 0, 0, 0, 0, 0, 0, 0, 0, 0, 0, 0, 0, 0, 0, 0, 0, 6,
6, 0, 0, 0, 0, 0, 0, 0, 0, 0, 5, 5, 5, 5, 5, 0, 0, 0, 0, 0, 0, 0, 0, 0, 6,
6, 0, 0, 1, 0, 0, 0, 0, 0, 0, 5, 5, 5, 5, 5, 0, 0, 0, 0, 0, 0, 2, 0, 0, 6,
6, 0, 0, 0, 0, 0, 0, 0, 0, 0, 5, 5, 13 5, 5, 0, 0, 0, 0, 0, 0, 0, 0, 0, 6,
6, 6, 6, 6, 6, 6, 6, 6, 6, 6, 6, 6, 6, 6, 6, 6, 6, 6, 6, 6, 6, 6, 6, 6, 6]

[6, 6, 6, 6, 6, 6, 6, 6, 6, 6, 6, 6, 6, 6, 6, 6, 6, 6, 6, 6, 6, 6, 6, 6, 6,
6, 0, 0, 0, 0, 0, 0, 0, 0, 0, 0, 0, 0, 0, 5, 0, 0, 0, 0, 0, 0, 0, 0, 0, 6,
6, 0, 3, 0, 0, 0, 0, 0, 0, 5, 0, 0, 0, 5, 5, 5, 0, 0, 0, 0, 0, 0, 3, 0, 6,
6, 0, 0, 0, 0, 0, 0, 0, 5, 5, 5, 0, 0, 0, 5, 0, 0, 0, 0, 0, 0, 0, 6, 6, 6,
6, 0, 0, 0, 0, 0, 0, 0, 0, 5, 0, 0, 0, 0, 0, 0, 0, 0, 0, 0, 0, 0, 0, 0, 6,
6, 0, 0, 0, 0, 0, 0, 0, 0, 0, 0, 0, 0, 0, 0, 0, 0, 0, 0, 0, 0, 0, 0, 0, 6,
6, 0, 0, 0, 0, 0, 6, 6, 6, 0, 0, 0, 0, 0, 0, 6, 6, 7, 7, 7, 7, 7, 7, 7, 6,
6, 0, 0, 0, 0, 0, 0, 0, 6, 6, 6, 0, 0, 6, 6, 6, 0, 0, 0, 0, 0, 0, 0, 0, 6,
6, 0, 0, 0, 0, 0, 0, 0, 0, 0, 6, 6, 6, 6, 5, 5, 0, 0, 0, 0, 5, 5, 5, 5, 6,
6, 0, 0, 0, 0, 0, 0, 0, 0, 0, 0, 0, 0, 5, 5, 5, 0, 0, 0, 0, 5, 5, 5, 5, 6,
6, 0, 0, 0, 0, 0, 0, 0, 0, 0, 0, 0, 0, 0, 5, 5, 0, 0, 0, 0, 0, 0, 0, 0, 6,
6, 0, 0, 5, 5, 5, 5, 0, 0, 0, 0, 0, 0, 0, 0, 0, 0, 0, 0, 0, 0, 0, 0, 0, 6,
6, 0, 0, 5, 5, 5, 5, 0, 0, 0, 0, 0, 0, 0, 0, 0, 0, 0, 0, 0, 1, 0, 0, 0, 6,
6, 0, 0, 0, 0, 5, 5, 6, 0, 0, 0, 0, 0, 0, 0, 0, 0, 0, 0, 0, 0, 0, 0, 0, 6,
6, 0, 0, 0, 0, 5, 5, 6, 0, 0, 5, 5, 5, 5, 5, 0, 0, 0, 0, 0, 2, 0, 0, 0, 6,
6, 0, 3, 0, 0, 0, 0, 6, 0, 0, 5, 5, 5, 5, 5, 0, 0, 0, 0, 0, 0, 0, 0, 0, 6,
6, 0, 0, 0, 0, 0, 0, 6, 0, 0, 5, 5, 13, 5, 5, 0, 0, 0, 0, 0, 0, 0, 0, 0, 6,
6, 6, 6, 6, 6, 6, 6, 6, 6, 6, 6, 6, 6, 6, 6, 6, 6, 6, 6, 6, 6, 6, 6, 6, 6],

[6, 6, 6, 6, 6, 6, 6, 6, 6, 6, 6, 6, 6, 6, 6, 6, 6, 6, 6, 6, 6, 6, 6, 6, 6,
6, 0, 0, 0, 0, 0, 0, 0, 9, 9, 9, 9, 9, 9, 9, 9, 0, 0, 0, 0, 0, 0, 0, 0, 6,
6, 0, 0, 0, 0, 0, 0, 0, 9, 9, 9, 9, 9, 9, 9, 9, 0, 5, 5, 0, 0, 1, 0, 0, 6,
6, 0, 0, 0, 0, 0, 0, 0, 9, 9, 9, 9, 9, 9, 9, 9, 0, 5, 5, 0, 0, 0, 0, 0, 6,
6, 0, 0, 0, 0, 0, 0, 0, 6, 6, 6, 6, 6, 6, 6, 6, 0, 5, 5, 0, 0, 0, 0, 0, 6,
6, 0, 0, 0, 0, 6, 0, 0, 0, 0, 0, 0, 0, 5, 5, 0, 0, 0, 0, 0, 0, 0, 0, 0, 6,
6, 0, 3, 0, 0, 6, 0, 0, 0, 0, 7, 0, 0, 5, 5, 0, 0, 0, 0, 5, 5, 6, 6, 6, 6,
6, 0, 0, 0, 0, 6, 0, 0, 0, 0, 7, 0, 0, 5, 5, 0, 0, 0, 0, 5, 5, 5, 0, 0, 6,
6, 0, 0, 0, 0, 6, 0, 0, 0, 0, 7, 0, 0, 0, 0, 0, 0, 0, 0, 5, 5, 5, 0, 13, 6,
6, 0, 0, 0, 0, 6, 3, 0, 0, 0, 7, 0, 0, 0, 0, 0, 0, 0, 0, 5, 5, 5, 0, 0, 6,
6, 0, 0, 0, 0, 6, 0, 0, 0, 0, 7, 0, 0, 5, 5, 0, 0, 0, 0, 5, 5, 5, 0, 0, 6,
6, 0, 3, 0, 0, 6, 0, 0, 0, 0, 8, 0, 0, 5, 5, 0, 0, 0, 0, 5, 5, 5, 6, 6, 6,
6, 0, 0, 0, 0, 6, 0, 0, 0, 0, 0, 0, 0, 5, 5, 0, 0, 0, 0, 0, 0, 0, 0, 0, 6,
6, 0, 0, 0, 0, 0, 0, 0, 6, 6, 6, 6, 6, 6, 6, 0, 0, 5, 5, 0, 0, 0, 0, 0, 6,
6, 0, 0, 0, 0, 0, 0, 0, 9, 9, 9, 9, 9, 9, 9, 0, 0, 5, 5, 0, 0, 0, 0, 0, 6,
6, 0, 0, 0, 0, 0, 0, 0, 9, 9, 9, 9, 9, 9, 9, 0, 0, 5, 5, 0, 0, 2, 0, 0, 6,
6, 0, 0, 0, 0, 0, 0, 0, 9, 9, 9, 9, 9, 9, 9, 0, 0, 0, 0, 0, 0, 0, 0, 0, 6,
6, 6, 6, 6, 6, 6, 6, 6, 6, 6, 6, 6, 6, 6, 6, 6, 6, 6, 6, 6, 6, 6, 6, 6, 6],


1 player1
2 player2
3 enemy
5 birck
6 steel
7 water
9 smoke
13 base